11111111111
11100011111
111P1E11111
111110C1111
11111111111