11111111111

1PEC0000001

10000000001

11111111111