11111111111
1P000C100C1
10011111001
1C001C0C001
10011011011
1C000001CE1
11111111111
