11111111111
1P00C0100C1
10011111001
1C001C0C001
10010011011
1C000001CE1
11111111111
