11111111111
1P0000100C1
10011111001
1C001000001
10010011011
1C000001CE1
11111111111
