
1PEC0000000

10000000000

11111111111