1111111111
1P0C0001C1
1111110101
1C1C0001E1
1011110101
1010000101
10001C0001
1101110101
1C00C001C1
1111111111