11111111111111111111111111111111111111
1P0000000C0000000000000000C00000000C01
10111111111111111111111111111111110101
1010000000C000000000000000000000010101
10101111111111111111111111111111C10101
10100000000000000000000000000000110101
101010111111111111111111111110000101C1
10100C0000000000000C000000000000110101
10101111111111111111111111111111010101
100000000000000000C0000000000000010101
10111111011111111111111111111111110101
10100000000000000000000000000000010101
101C11111111111111111111111111110101C1
1010000000000000000000000000000001C101
11111111111111111111111111111111110101
100C000000000000000000000000C0000000E1
11111111111111111111111111111111111111