1111111111111111111111111
1P00000000000000000000001
100000000000000000000C001
1000000011111111110000001
100000000000C000000000001
1000000001111111100000001
111111100000C000000111111
1111111000000000000111111
1000000001111111100000001
1000000001111111100000001
1C0000000000000000000C0E1
1111111111111111111111111
